              NO            ./includes/levels/textures
             SO        ./includes/levels/textures


        C                            225,30,0
        F                220  ,       100,          0
       EA              ./includes/levels/textures
       WE           ./includes/levels/textures


  11111111111111
  10010011E00101
  11111111111111