              NO            ./includes/levels/textures/eagle.xpm
             SO        ./includes/levels/textures/greenlight.xpm


         C                           42,     42,0
        F                42   ,       42,          0
       EA              ./includes/levels/textures/greystone.xpm
       WE           ./includes/levels/textures/greystone.xpm




111111111111111
100001000001101
10W000000000101
100000110000111
111111111111111