              NO            ./includes/levels/textures/texture.xpm
             SO        ./includes/levels/textures/eagle.xpm


         C                           42,     42,0
        F                42   ,       42,          0
       EA              ./includes/levels/textures/bluestone.xpm
       WE           ./includes/levels/textures/redbrick.xpm


11111111
10000001
101000S1
10000001
11111111