

        F        220,       70,          190









NO            ./includes/levels/textures/eagle.xpm

       EA              ./includes/levels/textures/greystone.xpm
       WE           ./includes/levels/textures/greystone.xpm
        C               102,       +74,           1                 





SO ./includes/levels/textures/greenlight.xpm
1111111111111111111111111111111111111111111111111111111111111111111111111111111111111111111111111
10000000000000000000000000000000000000000000000000000000000000000000000000000000000000000000000S1
1000000000000000000000000000000000000000000000000000000000000000000000000000000000000000000000001
1000000000000000000000000000000000000000000000010000000000000000000000000000000000000000000000001
1000000000000000000000000000000000000000000000000100000000000000000000000000000000000000000000001
1000000000000000000010000000000000000000000000000001000000000000000000000000000000000000000000001
1000000000000000000100000000000000000000000000000000001000000000000000000000000000000000000000001
1000000000000000001000000000000000000000000000000000000010000000000000000000000000000000000000001
1000000000000000000010000000000000000000000000000000000000000000001000000000000000000000000000001
1000000000000000000001000000000000000000000100000000000000000000001000000000000000000000000000001
1000000000000000000000000000000000000000010000000000000000000000001000000000000000000000000000001
1000000000000000000000000000000000010000000000000000000000000000000000000000001000000000000000001
1111111111111111111111111111111111111111111111111111111111111111111111111111111111111111111111111
