              NO            ./includes/levels/textures
             SO        ./includes/levels/textures


         C                           42,42,0
        F                42   ,       42,          0
       EA              ./includes/levels/textures
       WE           ./includes/levels/textures





11111111111111111
10000000001100001
10110000011100001
10010000E0000111
111111111011000011
1000000000110011
1111011110001101
1111111111111111

