

        F        2 ,       7+3,          190
        C                2,       +74,           1                 









NO            ./includes/levels/textures/eagle.xpm

SO ./includes/levels/textures/greenlight.xpm
       EA              ./includes/levels/textures/greystone.xpm
       WE           ./includes/levels/textures/greystone.xpm





11111111111111111111111111
1000000000000000000000 0W1
1111111111111111111111111
11111111111111111111111
11111111111111111111111