

	F        2 ,       1 2 3,          190
	C                2,       74,           1                 









NO            ./includes/levels/textures/eagle.xpm

SO ./includes/levels/textures/greenlight.xpm
			 EA              ./includes/levels/textures/greystone.xpm
			 WE           ./includes/levels/textures/greystone.xpm
 
 
111111
100001
100001
100001
100001
100N001
100001
111111







