              NO            ./includes/levels/textures/texture.xpm
             SO        ./includes/levels/textures/eagle.xpm


         C                           42,42,0
        F                42   ,       42,          0
       EA              ./includes/levels/textures/bluestone.xpm
       WE           ./includes/levels/textures/redbrick.xpm





111111111111
10000100001
100000000001
100000E100001
111111111111
