              NO            ./includes/levels/textures/texture.xpm
             SO        ./includes/levels/textures/texture.xpm


         C                           42,     42,0
        F                42   ,       42,          0
       EA              ./includes/levels/textures/texture.xpm
       WE           ./includes/levels/textures/texture.xpm

  1111111111111111111
 100000000000000000001
 1000000000000000000S1
 100000000000000000001
  1111111111111111111