              NO            ./includes/levels/textures/texture.xpm
             SO        ./includes/levels/textures/texture.xpm


         C                           42,     42,0
        F                42   ,       42,          0
       EA              ./includes/levels/textures/texture.xpm
       WE           ./includes/levels/textures/texture.xpm

  11111111111111111111
 1000000000000000000001
 10000000000000000000N1
 1000000000000000000001
  111111111111111111111