

	F        34 ,       177,          76
	C                97,       145,           254                









NO            ./includes/levels/textures/fixed_pipes.xpm

SO ./includes/levels/textures/brick.xpm
			 EA              ./includes/levels/textures/question.xpm
			 WE           ./includes/levels/textures/bush.xpm
 
 
111111
100001
100001
100001
100001
100N001
100001
111111







