              NO            ./includes/levels/textures
             SO        ./includes/levels/textures


         C                           42,42,0
        F                42   ,       42,          0
       EA              ./includes/levels/textures
       WE           ./includes/levels/textures





1111111111111111111111
1000000000110000000001
1011000001110000000001
1001000N00001110000001
111 101111100110000001
1111000001 10010000001
1111011111100100000001
1111111111111111111111