

        F        2 ,       7+3,          190
        C                2,       +74,           1                 









NO            ./includes/levels/textures/eagle.xpm

SO ./includes/levels/textures/greenlight.xpm
       EA              ./includes/levels/textures/greystone.xpm
       WE           ./includes/levels/textures/greystone.xpm





11111111111111111111111111
100000000000000000000000W1
10000000000000000000000011
100000000000000010000000001
10000000000000010000000001
10000000000000010000000001
1111111111111111111111111
11111111111111111111111
11111111111111111111111
    1