              NO            /Users/mohammoh/Desktop/cub3D/includes/levels/textures
             SO        /Users/mohammoh/Desktop/cub3D/includes/levels/textures


         C                           225,30,0
        F                220   ,       100,          0
       EA              /Users/mohammoh/Desktop/cub3D/includes/levels/textures
       WE           /Users/mohammoh/Desktop/cub3D/includes/levels/textures




11 1
10N1
11111
