              NO            /Users/mohammoh/Desktop/cub3D/includes/levels/textures
             SO        /Users/mohammoh/Desktop/cub3D/includes/levels/textures


         C                           225,30,0
        F                220   ,       100,          0
       EA              /Users/mohammoh/Desktop/cub3D/includes/levels/textures
       WE           /Users/mohammoh/Desktop/cub3D/includes/levels/textures





11111111111111111
1E000000001100001
10110000011100001
10010000000000111
111111111011000011
1000000000110011
1111011110001101
1111111111111111
