              NO            ./includes/levels/textures/texture.xpm
             SO        ./includes/levels/textures/texture.xpm


         C                           42,42,0
        F                42   ,       42,          0
       EA              ./includes/levels/textures/texture.xpm
       WE           ./includes/levels/textures/texture.xpm





11111
10001
10N01
10001
11111