              NO            ./includes/levels/textures/texture.xpm
             SO        ./includes/levels/textures/texture.xpm


         C                           42,42,0
        F                42   ,       42,          0
       EA              ./includes/levels/textures/texture.xpm
       WE           ./includes/levels/textures/texture.xpm





11111111111111111
11111111111111111
11N00000000000011
11000000000000011
11000000100000011
11000000000000011
11111111111111111
11111111111111111