              NO            ./includes/levels/textures/texture.xpm
             SO        ./includes/levels/textures/eagle.xpm


         C                           42,     42,0
        F                42   ,       42,          0
       EA              ./includes/levels/textures/bluestone.xpm
       WE           ./includes/levels/textures/redbrick.xpm


1111111111111111111111111111111111111111111111111111111111111111111111
1111111111111111111111111111111111111111111111111111111111111111111111
10100000000000000000000000000000000000000000000000000000000000000000S1
1111111111111111111111111111111111111111111111111111111111111111111111
