

        F        220,       70,          190









NO            ./includes/levels/textures/eagle.xpm

       EA              ./includes/levels/textures/greystone.xpm
       WE           ./includes/levels/textures/greystone.xpm
        C               102,       +74,           1                 





SO ./includes/levels/textures/greenlight.xpm
1111
10S1
1111
