              NO            ./includes/levels/textures
             SO        ./includes/levels/textures


         C                           42,42,0
        F                42   ,       42,          0
       EA              ./includes/levels/textures
       WE           ./includes/levels/textures





1111111111111111
1000000000110001
1011000001110001
1001000W00001111
111 101111100111
1111000001 10011
1111011111100101
1111111111111111

