

        F                42   ,       42,          0
        C                42   ,       42,          0









NO            ./includes/levels/textures/eagle.xpm

SO ./includes/levels/textures/greenlight.xpm
       EA              ./includes/levels/textures/greystone.xpm
       WE           ./includes/levels/textures/greystone.xpm



111111111
1E0000011
100010001
100111101
111    01
1111 1111
1111 1111